You are a lost soul traveling infinitely through the mortal world...and something is unsettling to you. You must find out why to have your soul finally rest in peace forever.

The Mansion
An Interactive Fiction by Jessie Chapman
Release 1 / Serial number 140314 / Inform 7 build 6G60 (I6/v6.32 lib 6/12N) SD

courtyard
You are in a grand courtyard located south of the mansion. To the east is an iron gate. To the north is the mansion. There is a wooden door to the mansion, which is closed.

You can see a wooden door and a gate here.

>go east
(first opening the gate)

cellar
You can see a gate here.

>go north
You can't go that way.

>go south
You can't go that way.

>go east
You can't go that way.

>go west
courtyard
You are in a grand courtyard located south of the mansion. To the east is a gate, slightly ajar. To the north is the mansion. There is a wooden door to the mansion, which appears closed.

You can see a gate here.

>open gate
That's already open.

>open door
You can't see any such thing.

>open wooden door
You can't see any such thing.

>go north
lobby

* * *

You are a lost soul traveling infinitely through the mortal world...and something is unsettling to you. You must find out why to have your soul finally rest in peace forever.

The Mansion
An Interactive Fiction by Jessie Chapman
Release 1 / Serial number 140314 / Inform 7 build 6G60 (I6/v6.32 lib 6/12N) SD

courtyard
You are in a grand courtyard located south of the mansion. To the east is an iron gate. To the north is the mansion. There is a wooden door to the mansion, which is closed.

You can see a wooden door and a gate here.

>open door
You see a lobby inside.

>open wooden door
That's already open.

>go north
lobby
You are in a long lobby. Down the hall you see a dim light, north of where you stand. There are pictures on the walls of the lobby.

You can see a wooden door here.

>go north
dining room
A candle sits on a dining room table, flickering. There are ceramic plates and bowls set on the table as if leftover from dinner. There are openings to other rooms to the east and west.

You can see a table and a watch here.

>examine bowl
You see nothing special about the bowls.

>take bowl
That's hardly portable.

>take candle
That's hardly portable.

>take table
You can't carry the table around!

>examine table
You see nothing special about the table.

>open table
That's not something you can open.

>take watch
Taken.

>examine watch
The face of the watch seems vaguely familiar. You recall seeing it many times, but are not sure where. This seems important.

>inventory
You are carrying:
  a watch

>go west
kitchen
You have come upon an old, dilapidated kitchen with stains on the floor and moldy food in the sink. A woman in a maid's outfit stands by the sink. She looks tired.

You can see a maid here.

>talk to maid
That's not a verb I recognise.

>ask maid about watch
There is no reply.

* * *

>open door
You see a lobby inside.

>enter
You must supply a noun.

>go north
lobby
You are in a long lobby. Down the hall you see a dim light. There are pictures on the walls of the lobby.

You can see a wooden door here.

* * *

>enter
You must supply a noun.

>enter lobby
You can't see any such thing.

>go through door
lobby
You are in a long lobby. Down the hall you see a dim light. There are pictures on the walls of the lobby.

You can see a wooden door here.

* * *

>enter
You must supply a noun.

>enter door
lobby
You are in a long lobby. Down the hall you see a dim light, north of where you stand. There are pictures on the walls of the lobby.

You can see a wooden door here.

>go north
dining room
A candle sits on a dining room table, flickering. There are ceramic plates and bowls set on the table as if leftover from dinner. There are openings to other rooms to the east and west.

You can see a table and a watch here.

>examine table
You see nothing special about the table.

* * *

>open door
You see a lobby inside.

>go through door
lobby
You are in a long lobby. Down the hall you see a dim light, north of where you stand. There are pictures on the walls of the lobby.

You can see a wooden door here.

>exit
But you aren't in anything at the moment.

>exit through door
I only understood you as far as wanting to exit.

>go south from lobby
I only understood you as far as wanting to go south.

>go south
courtyard
You are in a grand courtyard located south of the mansion. To the east is a gate, slightly ajar. To the north is the mansion. There is a wooden door to the mansion, which is closed.

You can see a wooden door and a gate here.

>open door
That's already open.

>enter
You must supply a noun.

* * *

>go through door
lobby
You are in a long lobby. Down the hall you see a dim light, north of where you stand. There are pictures on the walls of the lobby.

You can see a wooden door here.

>go north
dining room
A candle sits on a dining room table, flickering. There are ceramic plates and bowls set on the table as if leftover from dinner. There are openings to other rooms to the east and west.

You can see a table and a watch here.

>go east
study

>go west
dining room
A candle sits on a dining room table, flickering. There are ceramic plates and bowls set on the table as if leftover from dinner. There are openings to other rooms to the east and west.

You can see a table and a watch here.

>go west
kitchen

>go east
dining room
A candle sits on a dining room table, flickering. There are ceramic plates and bowls set on the table as if leftover from dinner. There are openings to other rooms to the east and west.

You can see a table and a watch here.

>go west
kitchen

>go north
You can't go that way.

>go west
You can't go that way.

>go south
cellar

>go north
kitchen

>go eas
You can't see any such thing.

>go east
dining room
A candle sits on a dining room table, flickering. There are ceramic plates and bowls set on the table as if leftover from dinner. There are openings to other rooms to the east and west.

You can see a table and a watch here.

>examine watch
The face of the watch seems vaguely familiar. You recall seeing it many times, but are not sure where. This seems important.

>take watch
Taken.

* * *

>open door
You see a lobby inside.

>enter lobby
You can't see any such thing.

>enter the lobby
You can't see any such thing.

>enter door
lobby
You are in a long lobby. Down the hall you see a dim light. There are pictures on the walls of the lobby.

You can see a wooden door here.

>go north
You can't go that way.

>go south
courtyard
You are in a grand courtyard located south of the mansion. To the east is a gate, slightly ajar. To the north is the mansion. There is a wooden door to the mansion, which is closed.

You can see a wooden door here.

>go north
lobby
You are in a long lobby. Down the hall you see a dim light. There are pictures on the walls of the lobby.

You can see a wooden door here.

>go south
courtyard
You are in a grand courtyard located south of the mansion. To the east is a gate, slightly ajar. To the north is the mansion. There is a wooden door to the mansion, which is closed.

You can see a wooden door here.

* * *

>go north
lobby
You are in a long lobby. Down the hall you see a dim light. There are pictures on the walls of the lobby.

You can see a wooden door here.

>go east
You can't go that way.

* * *

>enter lobby
You can't see any such thing.

>enter door
lobby
You are in a long lobby. Down the hall you see a dim light. There are pictures on the walls of the lobby.

You can see a wooden door here.

>go north
dining room
A candle sits on a dining room table, flickering. There are ceramic plates and bowls set on the table as if leftover from dinner.

>take candle
That's hardly portable.

>take bowls
That's hardly portable.

>take bowl
You can't see any such thing.

* * *

>enter lobby
You can't see any such thing.

>go through door
lobby
You are in a long lobby. Down the hall you see a dim light, north of where you stand. There are pictures on the walls of the lobby.

You can see a wooden door here.

>open door
That's already open.

>go through door
courtyard
You are in a grand courtyard located south of the mansion. To the east is a gate, slightly ajar. To the north is the mansion. There is a wooden door to the mansion, which is closed.

You can see a wooden door here.

>go through door
lobby
You are in a long lobby. Down the hall you see a dim light, north of where you stand. There are pictures on the walls of the lobby.

You can see a wooden door here.

>go north
dining room
A candle sits on a dining room table, flickering. There are ceramic plates and bowls set on the table as if leftover from dinner.

>take plate
That's hardly portable.

>take bowl
You can't see any such thing.

* * *

>go through door
lobby
You are in a long lobby. Down the hall you see a dim light, north of where you stand. There are pictures on the walls of the lobby.

You can see a wooden door here.

>go north
dining room
A candle sits on a dining room table, flickering. There are ceramic plates and bowls set on the table as if leftover from dinner. There are openings to other rooms to the east and west.

>examine table
You can't see any such thing.

* * *

>open door
You see a lobby inside.

>enter door
lobby
You are in a long lobby. Down the hall you see a dim light, north of where you stand. There are pictures on the walls of the lobby.

You can see a wooden door here.

>take table
The table is far too heavy.

>take door
That's fixed in place.

>take watch
Taken.

>inventory
You are carrying:
  a watch

>examine table
You see nothing special about the table.

>drop watch
Dropped.

>examine watch
You see nothing special about the watch.

>examine table
You see nothing special about the table.

* * *

>go north
dining room
A candle sits on a dining room table, flickering. There are ceramic plates and bowls set on the table as if leftover from dinner. There are openings to other rooms to the east and west.

You can see a table and a watch here.

>examine watch
The face of the watch seems vaguely familiar. You recall seeing it many times, but are not sure where. This seems important.

>examine table
You see nothing special about the table.

>take table
You can't carry The table around!

>take plate
That's hardly portable.

* * *

>go north
dining room
A candle sits on a dining room table, flickering. There are ceramic plates and bowls set on the table as if leftover from dinner. There are openings to other rooms to the east and west.

You can see a table and a watch here.

>go west
kitchen
You have come upon an old, dilapidated kitchen with stains on the floor and moldy food in the sink. A woman in a maid's outfit stands by the sink. She looks tired.

>go south
cellar
You entered a dark cellar. There isn't much in here besides a small friendly-looking mouse and a shiny object in the corner.

You can see a ring here.

>examine object
You see nothing special about the ring.

* * *

>open door
You see a lobby inside.

>go north
lobby
You are in a long lobby. Down the hall you see a dim light, north of where you stand. There are pictures on the walls of the lobby.

You can see a wooden door here.

* * *

>go south
cellar
You entered a dark cellar. There isn't much in here besides a small friendly-looking mouse and a shiny object in the corner.

You can see a ring here.

>examine ring
Upon examination you see that it is a small ring.

* * *

>go north
dining room
A candle sits on a dining room table, flickering. There are ceramic plates and bowls set on the table as if leftover from dinner. There are openings to other rooms to the east and west.

You can see a table and a watch here.

>go north
lounge
Upon entering a lounge you see a butler. He gives you a long, empty stare. It's kind of creepy. A closed door is to the right of the butler, who you really want to get away from, but considering he's one of few people who can tell you anything about this place, you may as well talk to him.

You can see a red door and a violin here.

>open door
You open the red door.

>go through door
bedroom
You entered a bedroom. It seems like the kind of place you would sleep - a plush, queen-sized bed...and a dog. Curled up on the bed. He wags his tail when he sees you and lets out a bark of excitement.

You can see a red door and a hat here.

>go through door
lounge
Upon entering a lounge you see a butler. He gives you a long, empty stare. It's kind of creepy. A closed door is to the right of the butler, who you really want to get away from, but considering he's one of few people who can tell you anything about this place, you may as well talk to him.

You can see a red door and a violin here.

>go west
bedroom
You entered a bedroom. It seems like the kind of place you would sleep - a plush, queen-sized bed...and a dog. Curled up on the bed. He wags his tail when he sees you and lets out a bark of excitement.

You can see a red door and a hat here.

>go east
lounge
Upon entering a lounge you see a butler. He gives you a long, empty stare. It's kind of creepy. A closed door is to the right of the butler, who you really want to get away from, but considering he's one of few people who can tell you anything about this place, you may as well talk to him.

You can see a red door and a violin here.

>go west
bedroom
You entered a bedroom. It seems like the kind of place you would sleep - a plush, queen-sized bed...and a dog. Curled up on the bed. He wags his tail when he sees you and lets out a bark of excitement.

You can see a red door and a hat here.

>go south
You can't go that way.

>go west
You can't go that way.

>go north
attic
You found yourself in a dusty attic. You feel a sneeze coming on because of the dust but can't seem to bring yourself to sneeze...weird. Your allergies kick in but your eyes aren't tearing either...still weird.

You can see a pair of reading glasses here.

>go north
You can't go that way.

>go east
You can't go that way.

>go west
You can't go that way.

>go south
bedroom
You entered a bedroom. It seems like the kind of place you would sleep - a plush, queen-sized bed...and a dog. Curled up on the bed. He wags his tail when he sees you and lets out a bark of excitement.

You can see a red door and a hat here.

>go north
attic
You found yourself in a dusty attic. You feel a sneeze coming on because of the dust but can't seem to bring yourself to sneeze...weird. Your allergies kick in but your eyes aren't tearing either...still weird.

You can see a pair of reading glasses here.

>go south
bedroom
You entered a bedroom. It seems like the kind of place you would sleep - a plush, queen-sized bed...and a dog. Curled up on the bed. He wags his tail when he sees you and lets out a bark of excitement.

You can see a red door and a hat here.

>take hat
Taken.

>inventory
You are carrying:
  a hat

>go south
You can't go that way.

>go east
lounge
Upon entering a lounge you see a butler. He gives you a long, empty stare. It's kind of creepy. A closed door is to the right of the butler, who you really want to get away from, but considering he's one of few people who can tell you anything about this place, you may as well talk to him.

You can see a red door and a violin here.

>go south
dining room
A candle sits on a dining room table, flickering. There are ceramic plates and bowls set on the table as if leftover from dinner. There are openings to other rooms to the east and west.

You can see a table and a watch here.

>go east
study
This room is so comforting...a study of sorts. A cat is curled up in the middle of the room. A bookcase on the opposite room has fallen over, revealing what looks like a door.

You can see an iron door, a book and a bookcase here.

>open door
You open the iron door.

>go through door
panic room
A wave of nostalgia comes over you as you enter this room - it is completely sealed off from the rest of the mansion: a panic room. A single chest stands in the middle of the room. The chest is appealing to you, but you don't know exactly why.

You can see an iron door and a chest here.

>open chest
That's not something you can open.

>put hat in chest
That can't contain things.

* * *

>open door
You see a lobby inside.

>open gate
A narrow passage leads to an opening at the end...seems intriguing.

>go through door
lobby
You are in a long lobby. Down the hall you see a dim light, north of where you stand. There are pictures on the walls of the lobby.

You can see a wooden door here.

>go through door
courtyard
You are in a grand courtyard located south of the mansion. To the east is an iron gate. To the north is the mansion. There is a wooden door to the mansion, which is closed.

You can see a wooden door and a gate here.

>go through gate
cellar
You entered a dark cellar. There isn't much in here besides a small friendly-looking mouse and a ring in the corner.

You can see a gate and a ring here.

>go through gate
courtyard
You are in a grand courtyard located south of the mansion. To the east is an iron gate. To the north is the mansion. There is a wooden door to the mansion, which is closed.

You can see a gate and a wooden door here.

>go through door
lobby
You are in a long lobby. Down the hall you see a dim light, north of where you stand. There are pictures on the walls of the lobby.

You can see a wooden door here.

>examine walls
You can't see any such thing.

>go north
dining room
A candle sits on a dining room table, flickering. There are ceramic plates and bowls set on the table as if leftover from dinner. There are openings to other rooms to the east and west.

You can see a table and a watch here.

>go east
study
This room is so comforting...a study of sorts. A cat is curled up in the middle of the room. A bookcase on the opposite room has fallen over, revealing what looks like a door.

You can see an iron door, a book and a bookcase here.

>go west
dining room
A candle sits on a dining room table, flickering. There are ceramic plates and bowls set on the table as if leftover from dinner. There are openings to other rooms to the east and west.

You can see a table and a watch here.

>go west
kitchen
You have come upon an old, dilapidated kitchen with stains on the floor and moldy food in the sink. A woman in a maid's outfit stands by the sink. She looks tired.

>go east
dining room
A candle sits on a dining room table, flickering. There are ceramic plates and bowls set on the table as if leftover from dinner. There are openings to other rooms to the east and west.

You can see a table and a watch here.

>go north
lounge
Upon entering a lounge you see a butler. He gives you a long, empty stare. It's kind of creepy. A closed door is to the right of the butler, who you really want to get away from, but considering he's one of few people who can tell you anything about this place, you may as well talk to him.

You can see a red door and a violin here.

>open door
You see a lobby inside.

>open red door
That's already open.

>go through door
bedroom
You entered a bedroom. It seems like the kind of place you would sleep - a plush, queen-sized bed...and a dog. Curled up on the bed. He wags his tail when he sees you and lets out a bark of excitement.

You can see a red door and a hat here.

* * *

You are a lost soul traveling infinitely through the mortal world...and something is unsettling to you. You must find out why to have your soul finally rest in peace forever.

The Mansion
An Interactive Fiction by Jessie Chapman
Release 1 / Serial number 140314 / Inform 7 build 6G60 (I6/v6.32 lib 6/12N) SD

courtyard
You are in a grand courtyard located south of the mansion. To the east is an iron gate. To the north is the mansion. There is a wooden door to the mansion, which is closed.

You can see a wooden door and a gate here.

>examine door
You see nothing special about the wooden door.

>examine gate
You see nothing special about the gate.

>open door
You open the wooden door.

>examine door
You see nothing special about the wooden door.

>open gate
You open the gate.

>go north
lobby
You can see a wooden door here.

>go east
You can't go that way.

>go south
courtyard
You are in a grand courtyard located south of the mansion. To the east is a gate, slightly ajar. To the north is the mansion. There is a wooden door to the mansion, which is closed.

You can see a wooden door and a gate here.

>go east
cellar
You can see a gate here.

>examine
(the gate)
You see nothing special about the gate.

>go east
You can't go that way.

>go west
courtyard
You are in a grand courtyard located south of the mansion. To the east is a gate, slightly ajar. To the north is the mansion. There is a wooden door to the mansion, which is closed.

You can see a gate and a wooden door here.

>open door
That's already open.

>go north
lobby
You can see a wooden door here.

* * *

>examine door
You see nothing special about the wooden door.

>open door
You see a lobby inside.

>unlock door
What do you want to unlock the wooden door with?

* * *

You are a lost soul traveling infinitely through the mortal world...and something is unsettling to you. You must find out why to have your soul finally rest in peace forever.

The Mansion
An Interactive Fiction by Jessie Chapman
Release 1 / Serial number 140314 / Inform 7 build 6G60 (I6/v6.32 lib 6/12N) SD

courtyard
You are in a grand courtyard located south of the mansion. To the east is an iron gate. To the north is the mansion. There is a wooden door to the mansion, which is closed.

You can see a wooden door and a gate here.

>go through door
(first opening the wooden door)
You see a lobby inside.

lobby
You are in a long lobby. Down the hall you see a dim light, north of where you stand. There are pictures on the walls of the lobby.

You can see a wooden door here.

>go north
dining room
A candle sits on a dining room table, flickering. There are ceramic plates and bowls set on the table as if leftover from dinner. There are openings to other rooms to the east and west.

>go east
You can't go that way.

* * *

You are a lost soul traveling infinitely through the mortal world...and something is unsettling to you. You must find out why to have your soul finally rest in peace forever.

The Mansion
An Interactive Fiction by Jessie Chapman
Release 1 / Serial number 140314 / Inform 7 build 6G60 (I6/v6.32 lib 6/12N) SD

courtyard
You are in a grand courtyard located south of the mansion. To the east is an iron gate. To the north is the mansion. There is a wooden door to the mansion, which is closed.

You can see a wooden door and a gate here.

>open gate
A narrow passage leads to an opening at the end...seems intriguing.

>go through gate
cellar
You entered a dark cellar. There isn't much in here besides a small friendly-looking mouse and a ring in the corner.

You can see a gate, a ring and a mouse here.

>go north
kitchen
You have come upon an old, dilapidated kitchen with stains on the floor and moldy food in the sink. A woman in a maid's outfit stands by the sink. She looks tired.

>go south
cellar
You entered a dark cellar. There isn't much in here besides a small friendly-looking mouse and a ring in the corner.

You can see a gate and a ring here.

>go east
You can't go that way.

* * *

>go west
You can't go that way.

>go through gate
courtyard
You are in a grand courtyard located south of the mansion. To the east is an iron gate. To the north is the mansion. There is a wooden door to the mansion, which is closed.

You can see a wooden door and a gate here.

>go north
(first opening the wooden door)
You see a lobby inside.

lobby
You are in a long lobby. Down the hall you see a dim light, north of where you stand. There are pictures on the walls of the lobby.

You can see a wooden door here.

>go north
dining room
A candle sits on a dining room table, flickering. There are ceramic plates and bowls set on the table as if leftover from dinner. There are openings to other rooms to the east and west.

You can see a table and a watch here.

* * *

>go west
kitchen
You have come upon an old, dilapidated kitchen with stains on the floor and moldy food in the sink. A woman in a maid's outfit stands by the sink. She looks tired.

>go south
cellar
You entered a dark cellar. There isn't much in here besides a small friendly-looking mouse and a ring in the corner.

You can see a gate and a ring here.

>go north
kitchen
You have come upon an old, dilapidated kitchen with stains on the floor and moldy food in the sink. A woman in a maid's outfit stands by the sink. She looks tired.

* * *

>go through gate
cellar
You entered a dark cellar. There isn't much in here besides a small friendly-looking mouse and a ring in the corner.

You can see a gate, a ring and a mouse here.

>pet mouse
MOUSE

>ask mouse about ring
This isn't Micky Mouse here. He doesn't know anything.

[Your score has just gone down by two points.]

>take ring
Taken.

>go north
kitchen
You have come upon an old, dilapidated kitchen with stains on the floor and moldy food in the sink. A woman in a maid's outfit stands by the sink. She looks tired.

You can see a maid here.

* * *

I beg your pardon?

>ask maid about watch
There is no reply.

* * *

>pet mouse
MOUSE

>pet mouse
MOUSE

>pet dog
You can't see any such thing.

>pet cat
You can't see any such thing.

* * *

>go through gate
cellar
You entered a dark cellar. There isn't much in here besides a small friendly-looking mouse and a ring in the corner.

You can see a gate, a ring and a mouse here.

>take ring
Taken.

* * *

>go north
kitchen
You have come upon an old, dilapidated kitchen with stains on the floor and moldy food in the sink. A woman in a maid's outfit stands by the sink. She looks tired.

You can see a maid here.

>go east
dining room
A candle sits on a dining room table, flickering. There are ceramic plates and bowls set on the table as if leftover from dinner. There are openings to other rooms to the east and west.

You can see a table and a watch here.

>go east
study
This room is so comforting...a study of sorts. A cat is curled up in the middle of the room. A bookcase on the opposite room has fallen over, revealing what looks like a door.

You can see an iron door, a book, a bookcase and a cat here.

>go east
(first opening the iron door)

panic room
A wave of nostalgia comes over you as you enter this room - it is completely sealed off from the rest of the mansion: a panic room. A single chest stands in the middle of the room. The chest is appealing to you, but you don't know exactly why.

You can see an iron door and a chest (closed) here.

>open chest
The inside of the chest has what seems to be 5 slots.

>put ring in chest
The ring fits perfectly!

[Your score has just gone up by ten points.]

>inventory
You are carrying nothing.

>examine chest
The combination on the lock is 6 digits...your birthday. How could this be? Who set the combination to this? This all still seems eerily familiar.

In the chest is a ring.

>take ring
Taken.

>inventory
You are carrying:
  a ring

>put ring in chest
The ring fits perfectly!

[Your score has just gone up by ten points.]

* * *

>go east
(first opening the iron door)

panic room
A wave of nostalgia comes over you as you enter this room - it is completely sealed off from the rest of the mansion: a panic room. A single chest stands in the middle of the room. The chest is appealing to you, but you don't know exactly why.

You can see an iron door and a chest (closed) here.

>put ring in chest
The ring fits perfectly!

[Your score has just gone up by ten points.]

>take ring
You can't see any such thing.

>examine chest
The combination on the lock is 6 digits...your birthday. How could this be? Who set the combination to this? This all still seems eerily familiar.

>open chest
The inside of the chest has what seems to be 5 slots.

>examine chest
The combination on the lock is 6 digits...your birthday. How could this be? Who set the combination to this? This all still seems eerily familiar.

In the chest is a ring.

>inventory
You are carrying nothing.

>take ring
Taken.

* * *

I beg your pardon?

>examine chest
The combination on the lock is 6 digits...your birthday. How could this be? Who set the combination to this? This all still seems eerily familiar.

>inventory
You are carrying:
  a ring

* * *

>go east
study
This room is so comforting...a study of sorts. A cat is curled up in the middle of the room. A bookcase on the opposite room has fallen over, revealing what looks like a door.

You can see an iron door, a book, a bookcase and a cat here.

>take book
Taken.

>go east
(first opening the iron door)

panic room
A wave of nostalgia comes over you as you enter this room - it is completely sealed off from the rest of the mansion: a panic room. A single chest stands in the middle of the room. The chest is appealing to you, but you don't know exactly why.

You can see an iron door and a chest (closed) here.

* * *

>open chest
The inside of the chest has what seems to be 5 slots.

>examine chest
The combination on the lock is 6 digits...your birthday. How could this be? Who set the combination to this? This all still seems eerily familiar.

>put book in chest
The book fits perfectly!

[Your score has just gone up by ten points.]

>inventory
You are carrying:
  a ring

>take book
Taken.

>inventory
You are carrying:
  a book
  a ring

>put book in chest
The book fits perfectly!

>take book
You already have that.

* * *

>put book in chest
The book fits perfectly!

[Your score has just gone up by ten points.]

>put ring in chest
The ring fits perfectly!

[Your score has just gone up by ten points.]

* * *

>inventory
You are carrying nothing.

>examine chest
The combination on the lock is 6 digits...your birthday. How could this be? Who set the combination to this? This all still seems eerily familiar.

In the chest are a ring and a book.

>take ring
Taken.

>invetory
That's not a verb I recognise.

>inventory
You are carrying:
  a ring

* * *

I beg your pardon?

>take book
Taken.

* * *

You are a lost soul traveling infinitely through the mortal world...and something is unsettling to you. You must find out why to have your soul finally rest in peace forever.

The Mansion
An Interactive Fiction by Jessie Chapman
Release 1 / Serial number 140314 / Inform 7 build 6G60 (I6/v6.32 lib 6/12N) SD

courtyard
You are in a grand courtyard located south of the mansion. To the east is an iron gate. To the north is the mansion. There is a wooden door to the mansion, which is closed.

You can see a wooden door and a gate here.

>go north
(first opening the wooden door)
You see a lobby inside.

lobby
You are in a long lobby. Down the hall you see a dim light, north of where you stand. There are pictures on the walls of the lobby.

You can see a wooden door and a pictures here.

>go north
dining room
A candle sits on a dining room table, flickering. There are ceramic plates and bowls set on the table as if leftover from dinner. There are openings to other rooms to the east and west.

You can see a table and a watch here.

I beg your pardon?

>go east
study
This room is so comforting...a study of sorts. A cat is curled up in the middle of the room. A bookcase on the opposite room has fallen over, revealing what looks like a door.

You can see an iron door, a book and a bookcase here.

>go east
(first opening the iron door)

panic room
A wave of nostalgia comes over you as you enter this room - it is completely sealed off from the rest of the mansion: a panic room. A single chest stands in the middle of the room. The chest is appealing to you, but you don't know exactly why.

You can see an iron door and a chest (closed) here.

* * *

>open chest
The inside of the chest has what seems to be 5 slots.

>go west
study
This room is so comforting...a study of sorts. A cat is curled up in the middle of the room. A bookcase on the opposite room has fallen over, revealing what looks like a door.

You can see an iron door, a book and a bookcase here.

>take book
Taken.

>go east
panic room
A wave of nostalgia comes over you as you enter this room - it is completely sealed off from the rest of the mansion: a panic room. A single chest stands in the middle of the room. The chest is appealing to you, but you don't know exactly why.

You can see an iron door and a chest (empty) here.

>put book in chest
You put the book into the chest.

>examine chest
In the chest is a book.

* * *

>go north
dining room
A candle sits on a dining room table, flickering. There are ceramic plates and bowls set on the table as if leftover from dinner. There are openings to other rooms to the east and west.

You can see a table and a watch here.

>go west
kitchen
You have come upon an old, dilapidated kitchen with stains on the floor and moldy food in the sink. A woman in a maid's outfit stands by the sink. She looks tired.

You can see a maid here.

>ask maid about sink
There is no reply.

>ask maid about watch
There is no reply.

>go east
dining room
A candle sits on a dining room table, flickering. There are ceramic plates and bowls set on the table as if leftover from dinner. There are openings to other rooms to the east and west.

You can see a table and a watch here.

>take watch
Taken.

>go west
kitchen
You have come upon an old, dilapidated kitchen with stains on the floor and moldy food in the sink. A woman in a maid's outfit stands by the sink. She looks tired.

You can see a maid here.

>ask maid about watch
There is no reply.

>go south
cellar
You entered a dark cellar. There isn't much in here besides a small friendly-looking mouse and a ring in the corner.

You can see a gate and a ring here.

>take gate
That's fixed in place.

>take mouse
You can't see any such thing.

>take ring
Taken.

* * *

>inventory
You are carrying:
  a ring

>drop ring
Dropped.

>take ring
Taken.

* * *

>ask maid about watch
There is no reply.

>ask maid about the watch
There is no reply.

>quiz maid about watch
That's not a verb I recognise.

>quiz maid about the watch
That's not a verb I recognise.

* * *

>go west
kitchen
You have come upon an old, dilapidated kitchen with stains on the floor and moldy food in the sink. A woman in a maid's outfit stands by the sink. She looks tired.

You can see a maid here.

>ask maid about the watch
There is no reply.

* * *

>go west
kitchen
You have come upon an old, dilapidated kitchen with stains on the floor and moldy food in the sink. A woman in a maid's outfit stands by the sink. She looks tired.

You can see a maid here.

>ask maid about fridge
ohhh

* * *

>go west
kitchen
You have come upon an old, dilapidated kitchen with stains on the floor and moldy food in the sink. A woman in a maid's outfit stands by the sink. She looks tired.

You can see a maid here.

>go south
cellar
You entered a dark cellar. There isn't much in here besides a small friendly-looking mouse and a ring in the corner.

You can see a gate, a ring and a mouse here.

>pet mouse
The mouse squeaks

* * *

>go south
cellar
You entered a dark cellar. There isn't much in here besides a small friendly-looking mouse and a ring in the corner.

You can see a gate, a ring and a mouse here.

>take ring
Taken.

* * *

>put ring in chest
The ring fits perfectly!

[Your score has just gone up by ten points.]

>take ring
You already have that.

>inventory
You are carrying:
  a ring

>examine chest
The combination on the lock is 6 digits...your birthday. How could this be? Who set the combination to this? This all still seems eerily familiar.

* * *

>go west
kitchen
You have come upon an old, dilapidated kitchen with stains on the floor and moldy food in the sink. A woman in a maid's outfit stands by the sink. She looks tired.

You can see a maid here.

>pet maid
You can't see any such thing.

>pet the maid
You can't see any such thing.

* * *

>go west
kitchen
You have come upon an old, dilapidated kitchen with stains on the floor and moldy food in the sink. A woman in a maid's outfit stands by the sink. She looks tired.

You can see a maid here.

>quiz the maid
That's not a verb I recognise.

>ask the maid
(about the maid)
WATCH

>ask the maid about the watch
There is no reply.

* * *

>go north
dining room
A candle sits on a dining room table, flickering. There are ceramic plates and bowls set on the table as if leftover from dinner. There are openings to other rooms to the east and west.

You can see a table and a watch here.

>take watch
Taken.

>go west
kitchen
You have come upon an old, dilapidated kitchen with stains on the floor and moldy food in the sink. A maid stands by the sink.

You can see a maid here.

>ask maid about watchg
There is no reply.

* * *

>go west
kitchen
You have come upon an old, dilapidated kitchen with stains on the floor and moldy food in the sink. A maid stands by the sink.

You can see a maid here.

>ask maid about watch
She replies, "Ah yes, I know that watch well. Your father passed it down to you on your 21st birthday. Unfortunately, after everyone else passed, it has just been lying in the dining room ever since..."

* * *

>go west
kitchen
You have come upon an old, dilapidated kitchen with stains on the floor and moldy food in the sink. A maid stands by the sink.

You can see a maid here.

>ask maid about the watch
WATCH

>ask maid
(about the watch)
WATCH

>ask maid abut the violin
I didn't understand that sentence.

>go south
cellar
You entered a dark cellar. There isn't much in here besides a small friendly-looking mouse and a ring in the corner.

You can see a gate, a ring and a mouse here.

* * *

>go north
kitchen
You have come upon an old, dilapidated kitchen with stains on the floor and moldy food in the sink. A woman in a maid's outfit stands by the sink. She looks tired.

You can see a maid here.

>ask maid
What do you want to ask the maid about?

>ask maid
What do you want to ask the maid about?

>ask maid about the ring
WATCH

>ask maid about the watch
WATCH

>ask maid about the ring
WATCH

* * *

>go west
kitchen
You have come upon an old, dilapidated kitchen with stains on the floor and moldy food in the sink. A maid stands by the sink.

You can see a maid here.

>go south
cellar
You entered a dark cellar. There isn't much in here besides a small friendly-looking mouse and a ring in the corner.

You can see a gate, a ring and a mouse here.

* * *

>take ring
Taken.

>go north
kitchen
You have come upon an old, dilapidated kitchen with stains on the floor and moldy food in the sink. A maid stands by the sink.

You can see a maid here.

>go east
dining room
A candle sits on a dining room table, flickering. There are ceramic plates and bowls set on the table as if leftover from dinner. There are openings to other rooms to the east and west.

You can see a table here.

>go east
study
This room is so comforting...a study of sorts. A cat is curled up in the middle of the room. A bookcase on the opposite room has fallen over, revealing what looks like a door.

You can see an iron door, a book, a bookcase and a cat here.

* * *

>take book
Taken.

>go west
dining room
A candle sits on a dining room table, flickering. There are ceramic plates and bowls set on the table as if leftover from dinner. There are openings to other rooms to the east and west.

You can see a table here.

>go north
lounge
Upon entering a lounge you see a butler. He gives you a long, empty stare. It's kind of creepy. A closed door is to the right of the butler, who you really want to get away from, but considering he's one of few people who can tell you anything about this place, you may as well talk to him.

You can see a red door, a violin and a butler here.

>take violin
Taken.

>go west
(first opening the red door)

bedroom
You entered a bedroom. It seems like the kind of place you would sleep - a plush, queen-sized bed...and a dog. Curled up on the bed. He wags his tail when he sees you.

You can see a red door, a hat and a dog here.

>take hot
You can't see any such thing.

>take hat
Taken.

>go north
attic
You found yourself in a dusty attic. You feel a sneeze coming on because of the dust but can't seem to bring yourself to sneeze...weird. Your allergies kick in but your eyes aren't tearing either...still weird. It's like your body can't respond to anything...if you even have a body at all...

You can see a pair of reading glasses here.

>take glasses
Taken.

>go south
bedroom
You entered a bedroom. It seems like the kind of place you would sleep - a plush, queen-sized bed...and a dog. Curled up on the bed. He wags his tail when he sees you.

You can see a red door and a dog here.

>go east
lounge
Upon entering a lounge you see a butler. He gives you a long, empty stare. It's kind of creepy. A closed door is to the right of the butler, who you really want to get away from, but considering he's one of few people who can tell you anything about this place, you may as well talk to him.

You can see a red door and a butler here.

>go south
dining room
A candle sits on a dining room table, flickering. There are ceramic plates and bowls set on the table as if leftover from dinner. There are openings to other rooms to the east and west.

You can see a table here.

>go east
study
This room is so comforting...a study of sorts. A cat is curled up in the middle of the room. A bookcase on the opposite room has fallen over, revealing what looks like a door.

You can see an iron door, a bookcase and a cat here.

>go east
(first opening the iron door)

panic room
A wave of nostalgia comes over you as you enter this room - it is completely sealed off from the rest of the mansion: a panic room. A single chest stands in the middle of the room. You have an urge to fill the chest with those things that are most important to you and keep them there forever, unable to be unlocked by anyone ever again...

You can see an iron door and a chest (closed) here.

>inventory
You are carrying:
  a pair of reading glasses
  a hat
  a violin
  a book
  a ring
  a watch

>examine chest
An ornate chest with music notes printed all over it: notes to your favorite song on the violin.

>open chest
You open the chest.

>examine chest
An ornate chest with music notes printed all over it: notes to your favorite song on the violin.

>lock chest
Locking an open chest...interesting choice. Ghosts can do whatever they want, I guess.

>open chest
That's already open.

>unlock chest
I guess you can unlock an already open chest...it must have ghostly magic by the rest of this place

>lock chest
Locking an open chest...interesting choice. Ghosts can do whatever they want, I guess.

>close chest
You close the chest.

>lock chest
Not just yet...there's more to put in here. You won't rest until all your mementos are safely hidden away.

>unlock chest
unlocking the chest gives you one step closer to accomplishing your goal

>put book in chest
The book fits perfectly!

>put ring in chest
The ring fits perfectly!

>put violin in chest
The violin fits perfectly!

>put glasses in chest
The reading glasses fit perfectly!

>put hat in chest
The hat fits perfectly!

>inventory
You are carrying:
  a watch

>put watch in chest
The watch fits perfectly!

>lock chest
    *** All of your mementos are safely tucked away. Your restless soul is now at peace. ***

In that game you scored 0 out of a possible 0, in 41 turns.

Would you like to RESTART, RESTORE a saved game, QUIT or UNDO the last command?

* * *

>take violin
Taken.

>go north
You can't go that way.

>go west
(first opening the red door)

bedroom
You entered a bedroom. It seems like the kind of place you would sleep - a plush, queen-sized bed...and a dog. Curled up on the bed. He wags his tail when he sees you.

You can see a red door, a hat and a dog here.

>take hat
Taken.

* * *

>go north
attic
You found yourself in a dusty attic. You feel a sneeze coming on because of the dust but can't seem to bring yourself to sneeze...weird. Your allergies kick in but your eyes aren't tearing either...still weird. It's like your body can't respond to anything...if you even have a body at all...

You can see a pair of reading glasses here.

>take glases
You can't see any such thing.

>go sout
You can't see any such thing.

>go s
bedroom
You entered a bedroom. It seems like the kind of place you would sleep - a plush, queen-sized bed...and a dog. Curled up on the bed. He wags his tail when he sees you.

You can see a red door and a dog here.

>go e
lounge
Upon entering a lounge you see a butler. He gives you a long, empty stare. It's kind of creepy. A closed door is to the right of the butler, who you really want to get away from, but considering he's one of few people who can tell you anything about this place, you may as well talk to him.

You can see a red door and a butler here.

>go s
dining room
A candle sits on a dining room table, flickering. There are ceramic plates and bowls set on the table as if leftover from dinner. There are openings to other rooms to the east and west.

You can see a table here.

>go e
study
This room is so comforting...a study of sorts. A cat is curled up in the middle of the room. A bookcase on the opposite room has fallen over, revealing what looks like a door.

You can see an iron door, a bookcase and a cat here.

>go e
(first opening the iron door)

panic room
A wave of nostalgia comes over you as you enter this room - it is completely sealed off from the rest of the mansion: a panic room. A single chest stands in the middle of the room. You have an urge to fill the chest with those things that are most important to you and keep them there forever, unable to be unlocked by anyone ever again...

You can see an iron door and a chest (closed) here.

>put ring in chest
The ring fits perfectly!

* * *

>put violin in chest
The violin fits perfectly!

>put book in chest
The book fits perfectly!

>put watch in chest
The watch fits perfectly!

>put hat in chest
The hat fits perfectly!

>put glasses in chest
You can't see any such thing.

>inventory
You are carrying nothing.

>go w
study
This room is so comforting...a study of sorts. A cat is curled up in the middle of the room. A bookcase on the opposite room has fallen over, revealing what looks like a door.

You can see an iron door, a bookcase and a cat here.

>go w
dining room
A candle sits on a dining room table, flickering. There are ceramic plates and bowls set on the table as if leftover from dinner. There are openings to other rooms to the east and west.

You can see a table here.

>go n
lounge
Upon entering a lounge you see a butler. He gives you a long, empty stare. It's kind of creepy. A closed door is to the right of the butler, who you really want to get away from, but considering he's one of few people who can tell you anything about this place, you may as well talk to him.

You can see a red door and a butler here.

>go w
bedroom
You entered a bedroom. It seems like the kind of place you would sleep - a plush, queen-sized bed...and a dog. Curled up on the bed. He wags his tail when he sees you.

You can see a red door and a dog here.

>go n
attic
You found yourself in a dusty attic. You feel a sneeze coming on because of the dust but can't seem to bring yourself to sneeze...weird. Your allergies kick in but your eyes aren't tearing either...still weird. It's like your body can't respond to anything...if you even have a body at all...

You can see a pair of reading glasses here.

>take glasses
Taken.

>go s
bedroom
You entered a bedroom. It seems like the kind of place you would sleep - a plush, queen-sized bed...and a dog. Curled up on the bed. He wags his tail when he sees you.

You can see a red door and a dog here.

* * *

>go e
study
This room is so comforting...a study of sorts. A cat is curled up in the middle of the room. A bookcase on the opposite room has fallen over, revealing what looks like a door.

You can see an iron door, a bookcase and a cat here.

>go e
panic room
A wave of nostalgia comes over you as you enter this room - it is completely sealed off from the rest of the mansion: a panic room. A single chest stands in the middle of the room. You have an urge to fill the chest with those things that are most important to you and keep them there forever, unable to be unlocked by anyone ever again...

You can see an iron door and a chest (closed) here.

>put glasses in chest
The reading glasses fit perfectly!

>lock chest
You seem to know what you're doing, but how did you know? You should probably talk to someone and ask them about the things you find. You can't just put stuff in here willy-nilly.

>go w
study
This room is so comforting...a study of sorts. A cat is curled up in the middle of the room. A bookcase on the opposite room has fallen over, revealing what looks like a door.

You can see an iron door, a bookcase and a cat here.

* * *

>go w
dining room
A candle sits on a dining room table, flickering. There are ceramic plates and bowls set on the table as if leftover from dinner. There are openings to other rooms to the east and west.

You can see a table here.

>go w
kitchen
You have come upon an old, dilapidated kitchen with stains on the floor and moldy food in the sink. A maid stands by the sink.

You can see a maid here.

>ask maid about watch
There is no reply.

>go e
dining room
A candle sits on a dining room table, flickering. There are ceramic plates and bowls set on the table as if leftover from dinner. There are openings to other rooms to the east and west.

You can see a table here.

>go e
study
This room is so comforting...a study of sorts. A cat is curled up in the middle of the room. A bookcase on the opposite room has fallen over, revealing what looks like a door.

You can see an iron door, a bookcase and a cat here.

* * *

>go e
panic room
A wave of nostalgia comes over you as you enter this room - it is completely sealed off from the rest of the mansion: a panic room. A single chest stands in the middle of the room. You have an urge to fill the chest with those things that are most important to you and keep them there forever, unable to be unlocked by anyone ever again...

You can see an iron door and a chest (closed) here.

>tke book
That's not a verb I recognise.

>take book
You can't see any such thing.

>unlock chest
Unlocking the chest gets you one step closer to accomplishing your goal

>take book
You can't see any such thing.

>examine chest
An ornate chest with music notes printed all over it: notes to your favorite song on the violin.

>open chest
You open the chest, revealing a pair of reading glasses, a hat, a watch, a book, a violin and a ring.

>take book
Taken.

>go w
study
This room is so comforting...a study of sorts. A cat is curled up in the middle of the room. A bookcase on the opposite room has fallen over, revealing what looks like a door.

You can see an iron door, a bookcase and a cat here.

* * *

>go w
kitchen
You have come upon an old, dilapidated kitchen with stains on the floor and moldy food in the sink. A maid stands by the sink.

You can see a maid here.

>ask maid about the book
Oh, you mean the violin sheet music? You used to love playing all those beautiful songs. You remember, don't you?

[Your score has just gone up by five points.]

>go e
dining room
A candle sits on a dining room table, flickering. There are ceramic plates and bowls set on the table as if leftover from dinner. There are openings to other rooms to the east and west.

You can see a table here.

* * *

>go e
study
This room is so comforting...a study of sorts. A cat is curled up in the middle of the room. A bookcase on the opposite room has fallen over, revealing what looks like a door.

You can see an iron door, a bookcase and a cat here.

>go e
panic room
A wave of nostalgia comes over you as you enter this room - it is completely sealed off from the rest of the mansion: a panic room. A single chest stands in the middle of the room. You have an urge to fill the chest with those things that are most important to you and keep them there forever, unable to be unlocked by anyone ever again...

You can see an iron door and a chest (in which are a pair of reading glasses, a hat, a watch, a violin and a ring) here.

>put book in chest
Yep, this seems like the spot for it.

>lock chest
You seem to know what you're doing, but how did you know? You should probably talk to someone and ask them about the things you find. You can't just put stuff in here willy-nilly.

>close chest
You close the chest.

>lock chest
You seem to know what you're doing, but how did you know? You should probably talk to someone and ask them about the things you find. You can't just put stuff in here willy-nilly.

>examine chest
An ornate chest with music notes printed all over it: notes to your favorite song on the violin.

>inventory
You are carrying nothing.

* * *

>go south
cellar
You entered a dark cellar. There isn't much in here besides a small friendly-looking mouse and a ring in the corner.

You can see a gate, a ring and a mouse here.

>take ting
You can't see any such thing.

>take ring
Taken.

* * *

>go east
dining room
A candle sits on a dining room table, flickering. There are ceramic plates and bowls set on the table as if leftover from dinner. There are openings to other rooms to the east and west.

You can see a table here.

>go north
lounge
Upon entering a lounge you see a butler. He gives you a long, empty stare. It's kind of creepy. A closed door is to the right of the butler, who you really want to get away from, but considering he's one of few people who can tell you anything about this place, you may as well talk to him.

You can see a red door, a violin and a butler here.

* * *

>go south
dining room
A candle sits on a dining room table, flickering. There are ceramic plates and bowls set on the table as if leftover from dinner. There are openings to other rooms to the east and west.

You can see a table here.

>go east
study
This room is so comforting...a study of sorts. A cat is curled up in the middle of the room. A bookcase on the opposite room has fallen over, revealing what looks like a door.

You can see an iron door, a book, a bookcase and a cat here.

* * *

>take book
Taken.

>go east
(first opening the iron door)

panic room
A wave of nostalgia comes over you as you enter this room - it is completely sealed off from the rest of the mansion: a panic room. A single chest stands in the middle of the room. You have an urge to fill the chest with those things that are most important to you and keep them there forever, unable to be unlocked by anyone ever again...

You can see an iron door and a chest (closed) here.

>inventory
You are carrying:
  a book
  a pair of reading glasses
  a hat
  a violin
  a ring
  a watch

>unlock chest
Unlocking the chest gets you one step closer to accomplishing your goal

>put book in chest
The book fits perfectly!

>put glasses in chest
The reading glasses fit perfectly!

* * *

>put hat in chest
The hat fits perfectly!

>put violin in chest
The violin fits perfectly!

>put ring in chest
The ring fits perfectly!

>put watch in chest
The watch fits perfectly!

>lock chest
    *** All of your mementos are safely tucked away. Your restless soul is now at peace. ***

In that game you scored 0 out of a possible 0, in 29 turns.

Would you like to RESTART, RESTORE a saved game, QUIT or UNDO the last command?

* * *

>take watch
Taken.

>go east
study
This room is so comforting...a study of sorts. A cat is curled up in the middle of the room. A bookcase on the opposite room has fallen over, revealing what looks like a door.

You can see an iron door, a book, a bookcase and a cat here.

* * *

>go east
(first opening the iron door)

panic room
A wave of nostalgia comes over you as you enter this room - it is completely sealed off from the rest of the mansion: a panic room. A single chest stands in the middle of the room. The chest is appealing to you, but you don't know exactly why.

You can see an iron door and a chest (closed) here.

>go west
study
This room is so comforting...a study of sorts. A cat is curled up in the middle of the room. A bookcase on the opposite room has fallen over, revealing what looks like a door.

You can see an iron door, a book, a bookcase and a cat here.

>take book
Taken.

>go east
panic room
A wave of nostalgia comes over you as you enter this room - it is completely sealed off from the rest of the mansion: a panic room. A single chest stands in the middle of the room. The chest is appealing to you, but you don't know exactly why.

You can see an iron door and a chest (closed) here.

>open chest
The inside of the chest has what seems to be 5 slots.

* * *

>examine chest
The combination on the lock is 6 digits...your birthday. How could this be? Who set the combination to this? This all still seems eerily familiar.

>put book in chest
It fits perfectly!

[Your score has just gone up by ten points.]

>examine chest
The combination on the lock is 6 digits...your birthday. How could this be? Who set the combination to this? This all still seems eerily familiar.

In the chest is a ring.

>inventory
You are carrying:
  a book
  a watch

* * *

>go east
(first opening the iron door)

panic room
A wave of nostalgia comes over you as you enter this room - it is completely sealed off from the rest of the mansion: a panic room. A single chest stands in the middle of the room. The chest is appealing to you, but you don't know exactly why.

You can see an iron door and a chest (closed) here.

>take key
Taken.

>go west
study
This room is so comforting...a study of sorts. A cat is curled up in the middle of the room. A bookcase on the opposite room has fallen over, revealing what looks like a door.

You can see an iron door, a book, a bookcase and a cat here.

>drop key
Dropped.

>go east
panic room
A wave of nostalgia comes over you as you enter this room - it is completely sealed off from the rest of the mansion: a panic room. A single chest stands in the middle of the room. The chest is appealing to you, but you don't know exactly why.

You can see an iron door and a chest (closed) here.

>open chest
You open the chest.

>unlock chest
The inside of the chest has what seems to be 5 slots.

>lock chest
mempts less than 5

* * *

>go east
(first opening the iron door)

panic room
A wave of nostalgia comes over you as you enter this room - it is completely sealed off from the rest of the mansion: a panic room. A single chest stands in the middle of the room. The chest is appealing to you, but you don't know exactly why.

You can see an iron door and a chest (closed) here.

>put book in chest
You can't see any such thing.

>open chest
That's already open.

>inventory
You are carrying:
  a watch

>close chest
You close the chest.

>put watch in chest
The watch fits perfectly!

[Your score has just gone up by ten points.]

* * *

>go east
(first opening the iron door)

panic room
A wave of nostalgia comes over you as you enter this room - it is completely sealed off from the rest of the mansion: a panic room. A single chest stands in the middle of the room. The chest is appealing to you, but you don't know exactly why.

You can see an iron door and a chest (closed) here.

>lock chest
lock/open memptzzzz

>close chest
You close the chest.

>lock chest
lock/closed mempts less than 5

>unlock chest
unlock/closed mempts less than 5

>close chest
That's already closed.

>open chest
You open the chest.

>unlock chest
unlock/open memptzzzz

* * *

>go east
(first opening the iron door)

panic room
A wave of nostalgia comes over you as you enter this room - it is completely sealed off from the rest of the mansion: a panic room. A single chest stands in the middle of the room. The chest is appealing to you, but you don't know exactly why.

You can see an iron door and a chest (closed) here.

>put watch in chest
nada
The watch fits perfectly!

[Your score has just gone up by ten points.]

* * *

>go east
(first opening the iron door)

panic room
A wave of nostalgia comes over you as you enter this room - it is completely sealed off from the rest of the mansion: a panic room. A single chest stands in the middle of the room. The chest is appealing to you, but you don't know exactly why.

You can see an iron door and a chest (closed) here.

>open chest
You open the chest.

>put book in chest
The book fits perfectly!

[Your score has just gone up by ten points.]

>inventory
You are carrying:
  a watch

>put watch in chest
The watch fits perfectly!

[Your score has just gone up by ten points.]

>examine chest
The combination on the lock is 6 digits...your birthday. How could this be? Who set the combination to this? This all still seems eerily familiar.

In the chest are a watch and a book.

>lock chest
What do you want to lock the chest with?

>lock chest with key
You can't see any such thing.

* * *

>open chest
You open the chest.

>examine chest
The chest is beautiful.

>unlock chest
The inside of the chest has what seems to be 5 slots.

>examine room
You can't see any such thing.

>inventory
You are carrying:
  a book
  a watch

>lock chest
mempts less than 5

>put book in chest
The book fits perfectly!

[Your score has just gone up by ten points.]

* * *

>go east
(first opening the iron door)

panic room
A wave of nostalgia comes over you as you enter this room - it is completely sealed off from the rest of the mansion: a panic room. A single chest stands in the middle of the room. The chest is appealing to you, but you don't know exactly why.

You can see an iron door and a chest (closed) here.

>put book in chest
The book fits perfectly!

>examine chest
The chest is beautiful.

>open chest
You open the chest, revealing a book.

>lock chest
lock/open memptzzzz

>open chest
That's already open.

>unlock chest
unlock/open memptzzzz

* * *

>go west
dining room
A candle sits on a dining room table, flickering. There are ceramic plates and bowls set on the table as if leftover from dinner. There are openings to other rooms to the east and west.

You can see a table here.

>go west
kitchen
You have come upon an old, dilapidated kitchen with stains on the floor and moldy food in the sink. A woman in a maid's outfit stands by the sink. She looks tired.

You can see a maid here.

* * *

>take ring
Taken.

>pet mouse
MOUSE

>ask mouse about ring
This isn't Micky Mouse here. He doesn't know anything. That was silly of you!

[Your score has just gone down by two points.]

>go north
kitchen
You have come upon an old, dilapidated kitchen with stains on the floor and moldy food in the sink. A woman in a maid's outfit stands by the sink. She looks tired.

You can see a maid here.

>go east
dining room
A candle sits on a dining room table, flickering. There are ceramic plates and bowls set on the table as if leftover from dinner. There are openings to other rooms to the east and west.

You can see a table here.

>go east
study
This room is so comforting...a study of sorts. A cat is curled up in the middle of the room. A bookcase on the opposite room has fallen over, revealing what looks like a door.

You can see an iron door, a bookcase and a cat here.

>go west
dining room
A candle sits on a dining room table, flickering. There are ceramic plates and bowls set on the table as if leftover from dinner. There are openings to other rooms to the east and west.

You can see a table here.

* * *

>take violin
Taken.

>go west
(first opening the red door)

bedroom
You entered a bedroom. It seems like the kind of place you would sleep - a plush, queen-sized bed...and a dog. Curled up on the bed. He wags his tail when he sees you and lets out a bark of excitement.

You can see a red door, a hat and a dog here.

>take hat
Taken.

>go north
attic
You found yourself in a dusty attic. You feel a sneeze coming on because of the dust but can't seem to bring yourself to sneeze...weird. Your allergies kick in but your eyes aren't tearing either...still weird.

You can see a pair of reading glasses here.

>take glasses
Taken.

>go south
bedroom
You entered a bedroom. It seems like the kind of place you would sleep - a plush, queen-sized bed...and a dog. Curled up on the bed. He wags his tail when he sees you and lets out a bark of excitement.

You can see a red door and a dog here.

>go east
lounge
Upon entering a lounge you see a butler. He gives you a long, empty stare. It's kind of creepy. A closed door is to the right of the butler, who you really want to get away from, but considering he's one of few people who can tell you anything about this place, you may as well talk to him.

You can see a red door and a butler here.

* * *

>go east
study
This room is so comforting...a study of sorts. A cat is curled up in the middle of the room. A bookcase on the opposite room has fallen over, revealing what looks like a door.

You can see an iron door, a bookcase and a cat here.

>go east
(first opening the iron door)

panic room
A wave of nostalgia comes over you as you enter this room - it is completely sealed off from the rest of the mansion: a panic room. A single chest stands in the middle of the room. The chest is appealing to you, but you don't know exactly why.

You can see an iron door, a rusty key and a chest (empty) here.

>open chest
That's already open.

>examine chest
The chest is beautiful.

* * *

>unlock chest
The inside of the chest has what seems to be 5 slots.

>examine chest
The chest is beautiful.

>lock chest
mempts less than 5

>open chest
That's already open.

>unlock chest
The inside of the chest has what seems to be 5 slots.

>put ring in chest
The ring fits perfectly!

[Your score has just gone up by ten points.]

>inventory
You are carrying:
  a pair of reading glasses
  a hat
  a violin
  a book
  a watch

>put hat in chest
The hat fits perfectly!

[Your score has just gone up by ten points.]

>put glasses in chest
The reading glasses fit perfectly!

[Your score has just gone up by ten points.]

>put violin in chest
The violin fits perfectly!

[Your score has just gone up by ten points.]

>put book in chest
The book fits perfectly!

[Your score has just gone up by ten points.]

>put watch in chest
The watch fits perfectly!

[Your score has just gone up by ten points.]

>inventory
You are carrying nothing.

>lock chest
YOU WON

* * *

>take watch
Taken.

>go w
kitchen
You have come upon an old, dilapidated kitchen with stains on the floor and moldy food in the sink. A maid stands by the sink.

You can see a maid here.

>go s
cellar
You entered a dark cellar. There isn't much in here besides a small friendly-looking mouse and a ring in the corner.

You can see a gate, a ring and a mouse here.

>take ring
Taken.

>go n
kitchen
You have come upon an old, dilapidated kitchen with stains on the floor and moldy food in the sink. A maid stands by the sink.

You can see a maid here.

>go e
dining room
A candle sits on a dining room table, flickering. There are ceramic plates and bowls set on the table as if leftover from dinner. There are openings to other rooms to the east and west.

You can see a table here.

>go n
lounge
Upon entering a lounge you see a butler. He gives you a long, empty stare. It's kind of creepy. A closed door is to the right of the butler, who you really want to get away from, but considering he's one of few people who can tell you anything about this place, you may as well talk to him.

You can see a red door, a violin and a butler here.

>take violin
Taken.

>go w
(first opening the red door)

bedroom
You entered a bedroom. It seems like the kind of place you would sleep - a plush, queen-sized bed...and a dog. Curled up on the bed. He wags his tail when he sees you.

You can see a red door, a hat and a dog here.

>take hat
Taken.

>go n
attic
You found yourself in a dusty attic. You feel a sneeze coming on because of the dust but can't seem to bring yourself to sneeze...weird. Your allergies kick in but your eyes aren't tearing either...still weird. It's like your body can't respond to anything...if you even have a body at all...

You can see a pair of reading glasses here.

* * *

>go s
dining room
A candle sits on a dining room table, flickering. There are ceramic plates and bowls set on the table as if leftover from dinner. There are openings to other rooms to the east and west.

You can see a table here.

>go e
study
This room is so comforting...a study of sorts. A cat is curled up in the middle of the room. A bookcase on the opposite room has fallen over, revealing what looks like a door.

You can see an iron door, a book, a bookcase and a cat here.

>take book
Taken.

>go e
(first opening the iron door)

panic room
A wave of nostalgia comes over you as you enter this room - it is completely sealed off from the rest of the mansion: a panic room. A single chest stands in the middle of the room. You have an urge to fill the chest with those things that are most important to you and keep them there forever, unable to be unlocked by anyone ever again...

You can see an iron door and a chest (closed) here.

* * *

>put ring in chest
The ring fits perfectly!

>put book in chest
The book fits perfectly!

>put hat in chest
The hat fits perfectly!

>open chest
You open the chest, revealing a hat, a book and a ring.

>put glasses in chest
The reading glasses fit perfectly!

>inventory
You are carrying:
  a violin
  a watch

>put violin in chest
The violin fits perfectly!

>put watch in chest
The watch fits perfectly!

>inventory
You are carrying nothing.

>open chest
That's already open.

>lock chest
You seem to know what you're doing, but how did you know? You should probably take something out and talk to someone about it. You can't just put stuff in here willy-nilly.

>close chest
You close the chest.

>lock chest
You seem to know what you're doing, but how did you know? You should probably take something out and talk to someone about it. You can't just put stuff in here willy-nilly.

>open chest
You open the chest, revealing a watch, a violin, a pair of reading glasses, a hat, a book and a ring.

>take violin
Taken.

>go w
study
This room is so comforting...a study of sorts. A cat is curled up in the middle of the room. A bookcase on the opposite room has fallen over, revealing what looks like a door.

You can see an iron door, a bookcase and a cat here.

* * *

>go w
kitchen
You have come upon an old, dilapidated kitchen with stains on the floor and moldy food in the sink. A maid stands by the sink.

You can see a maid here.

>ask maid about violin
Your old violin! I'm surprised it hasn't disintegrated after all these years.

[Your score has just gone up by five points.]

>go e
dining room
A candle sits on a dining room table, flickering. There are ceramic plates and bowls set on the table as if leftover from dinner. There are openings to other rooms to the east and west.

You can see a table here.

* * *

>go e
study
This room is so comforting...a study of sorts. A cat is curled up in the middle of the room. A bookcase on the opposite room has fallen over, revealing what looks like a door.

You can see an iron door, a bookcase and a cat here.

>go e
panic room
A wave of nostalgia comes over you as you enter this room - it is completely sealed off from the rest of the mansion: a panic room. A single chest stands in the middle of the room. You have an urge to fill the chest with those things that are most important to you and keep them there forever, unable to be unlocked by anyone ever again...

You can see an iron door and a chest (in which are a watch, a pair of reading glasses, a hat, a book and a ring) here.

>put violin in chest
Yep, this seems like the spot for it.

>open chest
That's already open.

* * *

>take violin
Taken.

>go n
You can't go that way.

>go w
(first opening the red door)

bedroom
You entered a bedroom. It seems like the kind of place you would sleep - a plush, queen-sized bed...and a dog. Curled up on the bed. He wags his tail when he sees you.

You can see a red door, a hat and a dog here.

* * *

>go e
(first opening the iron door)

panic room
A wave of nostalgia comes over you as you enter this room - it is completely sealed off from the rest of the mansion: a panic room. A single chest stands in the middle of the room. You have an urge to fill the chest with those things that are most important to you and keep them there forever, unable to be unlocked by anyone ever again...

You can see an iron door and a chest (closed) here.

>put book in chest
The book fits perfectly!

* * *

>put ring in chest
The ring fits perfectly!

>put glasses in chest
The reading glasses fit perfectly!

>put violin in chest
The violin fits perfectly!

>put hat in chest
The hat fits perfectly!

>put watch in chest
The watch fits perfectly!

>lock chest
    *** All of your mementos are safely tucked away. Your restless soul is now at peace. ***

In that game you scored 0 out of a possible 0, in 28 turns.

Would you like to RESTART, RESTORE a saved game, QUIT or UNDO the last command?

* * *

>go north
dining room
A candle sits on a dining room table, flickering. There are ceramic plates and bowls set on the table as if leftover from dinner. There are openings to other rooms to the east and west.

You can see a table and a watch here.

>go east
study
This room is so comforting...a study of sorts. A cat is curled up in the middle of the room. A bookcase on the opposite room has fallen over, revealing what looks like a door.

You can see an iron door, a book, a bookcase and a cat here.

* * *

>take book
Taken.

>go east
(first opening the iron door)

panic room
A wave of nostalgia comes over you as you enter this room - it is completely sealed off from the rest of the mansion: a panic room. A single chest stands in the middle of the room. The chest is appealing to you, but you don't know exactly why.

You can see an iron door, a rusty key and a chest (empty) here.

>take key
Taken.

>examine chest
The chest is beautiful.

* * *

>unlock chest
The inside of the chest has what seems to be 5 slots.

>open chest
That's already open.

>lock chest
What do you want to lock the chest with?

>lock chest with key
First you'll have to close the chest.

>close chest
You close the chest.

>lock chest with key
You lock the chest.

>open chest
It seems to be locked.

>examine chest
The chest is beautiful.

* * *

>unlock chest
The inside of the chest has what seems to be 5 slots.

>inventory
You are carrying:
  a rusty key
  a book

>drop key
Dropped.

>lock chest
(with the book)
That doesn't seem to fit the lock.

>take key
Taken.

>lock chest with key
You lock the chest.

* * *

>go north
(first opening the wooden door)
You see a lobby inside.

lobby
You are in a long lobby. Down the hall you see a dim light, north of where you stand. There are pictures on the walls of the lobby.

You can see a wooden door and a pictures here.

>go south
courtyard
You are in a grand courtyard located south of the mansion. To the east is an iron gate. To the north is the mansion. There is a wooden door to the mansion, which is closed.

You can see a wooden door and a gate here.

>open gate
A narrow passage leads to an opening at the end...seems intriguing.

>enter
You must supply a noun.

>enter gate
cellar
You entered a dark cellar. There isn't much in here besides a small friendly-looking mouse and a ring in the corner.

You can see a gate, a ring and a mouse here.

>take mouse
I don't suppose the mouse would care for that.

>take ring
Taken.

* * *

>go north
kitchen
You have come upon an old, dilapidated kitchen with stains on the floor and moldy food in the sink. A woman in a maid's outfit stands by the sink. She looks tired.

You can see a maid here.

>ask maid about ring
maid ring

>go east
dining room
A candle sits on a dining room table, flickering. There are ceramic plates and bowls set on the table as if leftover from dinner. There are openings to other rooms to the east and west.

You can see a table and a watch here.

* * *

>take watch
Taken.

>go north
lounge
Upon entering a lounge you see a butler. He gives you a long, empty stare. It's kind of creepy. A closed door is to the right of the butler, who you really want to get away from, but considering he's one of few people who can tell you anything about this place, you may as well talk to him.

You can see a red door, a violin and a butler here.

>ask butler about watch
butler watch

>ask butler about ring
butler ring

>ask butler about violin
butler violin

>take violin
Taken.

>inventory
You are carrying:
  a violin
  a watch
  a ring

>go west
(first opening the red door)

bedroom
You entered a bedroom. It seems like the kind of place you would sleep - a plush, queen-sized bed...and a dog. Curled up on the bed. He wags his tail when he sees you and lets out a bark of excitement.

You can see a red door, a hat and a dog here.

>pet dog
The dog wags its tail and barks.

>ask dog about ring
Man's best friend...you wish he could talk! I'm sure he'd have some great stories to tell.

>go north
attic
You found yourself in a dusty attic. You feel a sneeze coming on because of the dust but can't seem to bring yourself to sneeze...weird. Your allergies kick in but your eyes aren't tearing either...still weird.

You can see a pair of reading glasses here.

>examine glasses
You see nothing special about the pair of reading glasses.

>examine reading glasses
You see nothing special about the pair of reading glasses.

>take glasses
Taken.

>inventory
You are carrying:
  a pair of reading glasses
  a violin
  a watch
  a ring

>go south
bedroom
You entered a bedroom. It seems like the kind of place you would sleep - a plush, queen-sized bed...and a dog. Curled up on the bed. He wags his tail when he sees you and lets out a bark of excitement.

You can see a red door, a hat and a dog here.

>go east
lounge
Upon entering a lounge you see a butler. He gives you a long, empty stare. It's kind of creepy. A closed door is to the right of the butler, who you really want to get away from, but considering he's one of few people who can tell you anything about this place, you may as well talk to him.

You can see a red door and a butler here.

* * *

>go east
study
This room is so comforting...a study of sorts. A cat is curled up in the middle of the room. A bookcase on the opposite room has fallen over, revealing what looks like a door.

You can see an iron door, a book, a bookcase and a cat here.

>take bookcase
You don't have pockets big enough for that...

>pet cat
The cat purrs

>ask cat about book
It can only purr, silly. It probably doesn't care what you have to say anyway...it's a cat.

>examine book
A book of sheet music for the violin.

>take book
Taken.

>invetory
That's not a verb I recognise.

>inventory
You are carrying:
  a book
  a pair of reading glasses
  a violin
  a watch
  a ring

>go east
(first opening the iron door)

panic room
A wave of nostalgia comes over you as you enter this room - it is completely sealed off from the rest of the mansion: a panic room. A single chest stands in the middle of the room. The chest is appealing to you, but you don't know exactly why.

You can see an iron door and a chest (closed) here.

* * *

>examine chest
The combination on the lock is 6 digits...your birthday. How could this be? Who set the combination to this? This all still seems eerily familiar.

>put ring in chest
You put the ring into the chest.

>examine chest
The combination on the lock is 6 digits...your birthday. How could this be? Who set the combination to this? This all still seems eerily familiar.

In the chest is a ring.

>put violin in chest
You put the violin into the chest.

>examine chest
The combination on the lock is 6 digits...your birthday. How could this be? Who set the combination to this? This all still seems eerily familiar.

In the chest are a violin and a ring.

>inventory
You are carrying:
  a book
  a pair of reading glasses
  a watch

* * *

You are a lost soul traveling infinitely through the mortal world...and something is unsettling to you. You must find out why to have your soul finally rest in peace forever.

The Mansion
An Interactive Fiction by Jessie Chapman
Release 1 / Serial number 140314 / Inform 7 build 6G60 (I6/v6.32 lib 6/12N) SD

courtyard
You are in a grand courtyard located south of the mansion. To the east is an iron gate. To the north is the mansion. There is a wooden door to the mansion, which is closed.

You can see a wooden door and a gate here.

>go west
You can't go that way.

>open gate
A narrow passage leads to an opening at the end...seems intriguing.

>go west
You can't go that way.

>go south
You can't go that way.

>go north
(first opening the wooden door)
You see a lobby inside.

lobby
You are in a long lobby. Down the hall you see a dim light, north of where you stand. There are pictures on the walls of the lobby.

You can see a wooden door here.

* * *

>go west
kitchen
You have come upon an old, dilapidated kitchen with stains on the floor and moldy food in the sink. A woman in a maid's outfit stands by the sink. She looks tired.

You can see a maid here.

>ask maid about violin
There is no reply.

>ask maid about watch
There is no reply.

>go south
cellar
You entered a dark cellar. There isn't much in here besides a small friendly-looking mouse and a ring in the corner.

You can see a gate, a ring and a mouse here.

* * *

>pet mouse
The mouse squeaks

>go north
kitchen
You have come upon an old, dilapidated kitchen with stains on the floor and moldy food in the sink. A woman in a maid's outfit stands by the sink. She looks tired.

You can see a maid here.

* * *

>go south
cellar
You entered a dark cellar. There isn't much in here besides a small friendly-looking mouse and a ring in the corner.

You can see a gate, a ring and a mouse here.

>ask mouse about watch
It can't talk!

* * *

You are a lost soul traveling infinitely through the mortal world...and something is unsettling to you. You must find out why to have your soul finally rest in peace forever.

The Mansion
An Interactive Fiction by Jessie Chapman
Release 1 / Serial number 140314 / Inform 7 build 6G60 (I6/v6.32 lib 6/12N) SD

courtyard
You are in a grand courtyard located south of the mansion. To the east is an iron gate. To the north is the mansion. There is a wooden door to the mansion, which is closed.

You can see a wooden door and a gate here.

>go n
(first opening the wooden door)
You see a lobby inside.

lobby
You are in a long lobby. Down the hall you see a dim light, north of where you stand. There are pictures on the walls of the lobby.

You can see a wooden door and a pictures here.

>examine pictures
A couple old photos hang askew on the walls. A woman and...a man... . You. You are with the woman, who is wearing a flowing white dress and a veil. You are wearing a tuxedo. How can this be? What does this mean?

>go n
dining room
A candle sits on a dining room table, flickering. There are ceramic plates and bowls set on the table as if leftover from dinner. There are openings to other rooms to the east and west.

You can see a table and a watch here.

>take watch
Taken.

* * *

>examine watch
The face of the watch seems vaguely familiar. You recall seeing it many times, but are not sure where. This seems important.

>go e
study
This room is so comforting...a study of sorts. A cat is curled up in the middle of the room. A bookcase on the opposite room has fallen over, revealing what looks like a door.

You can see an iron door, a book, a bookcase and a cat here.

>go e
(first opening the iron door)

panic room
A wave of nostalgia comes over you as you enter this room - it is completely sealed off from the rest of the mansion: a panic room. A single chest stands in the middle of the room. You have an urge to fill the chest with those things that are most important to you and keep them there forever, unable to be unlocked by anyone ever again...

You can see an iron door and a chest (closed) here.

>examine chest
An ornate chest with music notes printed all over it: notes to your favorite song on the violin.

* * *

>open chest
You open the chest.

>unlock chest
I guess you can unlock an already open chest...it must have ghostly magic by the rest of this place